//MAP CONVERTED BY dmm2tgm.py THIS HEADER COMMENT PREVENTS RECONVERSION, DO NOT REMOVE
"a" = (
/turf/open/floor/plating/asteroid/terraformable,
/area/ruin/unpowered/ancient_bunker_outside)
"b" = (
/turf/closed/mineral,
/area/ruin/unpowered/ancient_bunker_outside)
"c" = (
/turf/closed/indestructible/r_wall,
/area/ruin/powered/ancient_bunker_vault)
"d" = (
/turf/open/floor/plasteel,
/area/ruin/powered/ancient_bunker_vault)
"e" = (
/turf/closed/wall/r_wall,
/area/ruin/powered/ancient_bunker_vault)
"f" = (
/obj/structure/filingcabinet,
/turf/open/floor/plasteel,
/area/ruin/powered/ancient_bunker_vault)
"g" = (
/turf/open/floor/plating,
/area/ruin/powered/ancient_bunker_vault)
"h" = (
/obj/machinery/door/airlock/engineering,
/turf/open/floor/plasteel,
/area/ruin/powered/ancient_bunker_vault)
"i" = (
/obj/effect/turf_decal/stripes/line{
	dir = 9
	},
/turf/open/floor/plasteel,
/area/ruin/powered/ancient_bunker_vault)
"j" = (
/obj/effect/turf_decal/stripes/line{
	dir = 1
	},
/turf/open/floor/plasteel,
/area/ruin/powered/ancient_bunker_vault)
"k" = (
/obj/structure/fluff/ancient_turret,
/obj/effect/turf_decal/stripes/line{
	dir = 5
	},
/turf/open/floor/plasteel,
/area/ruin/powered/ancient_bunker_vault)
"l" = (
/obj/effect/decal/remains/human,
/obj/effect/turf_decal/stripes/line{
	dir = 8
	},
/turf/open/floor/plasteel,
/area/ruin/powered/ancient_bunker_vault)
"m" = (
/obj/machinery/holopad/tutorial,
/turf/open/floor/plasteel,
/area/ruin/powered/ancient_bunker_vault)
"n" = (
/obj/effect/turf_decal/stripes/line{
	dir = 4
	},
/turf/open/floor/plasteel,
/area/ruin/powered/ancient_bunker_vault)
"o" = (
/obj/effect/turf_decal/stripes/line{
	dir = 8
	},
/turf/open/floor/plasteel,
/area/ruin/powered/ancient_bunker_vault)
"p" = (
/obj/item/disk/holodisk/ancient_bunker/outside,
/obj/effect/turf_decal/stripes/line{
	dir = 4
	},
/turf/open/floor/plasteel,
/area/ruin/powered/ancient_bunker_vault)
"q" = (
/obj/structure/table,
/turf/open/floor/plasteel,
/area/ruin/powered/ancient_bunker_vault)
"r" = (
/obj/effect/decal/remains/human,
/obj/effect/turf_decal/stripes/line{
	dir = 4
	},
/turf/open/floor/plasteel,
/area/ruin/powered/ancient_bunker_vault)
"s" = (
/obj/effect/turf_decal/stripes/line,
/turf/open/floor/plating,
/area/ruin/powered/ancient_bunker_vault)
"t" = (
/obj/effect/decal/remains/robot,
/turf/open/floor/plasteel,
/area/ruin/powered/ancient_bunker_vault)
"u" = (
/obj/item/chair,
/obj/effect/turf_decal/stripes/line{
	dir = 4
	},
/turf/open/floor/plasteel,
/area/ruin/powered/ancient_bunker_vault)
"v" = (
/obj/machinery/power/rtg,
/turf/open/floor/plasteel,
/area/ruin/powered/ancient_bunker_vault)
"w" = (
/obj/effect/turf_decal/stripes/line{
	dir = 10
	},
/turf/open/floor/plasteel,
/area/ruin/powered/ancient_bunker_vault)
"x" = (
/obj/effect/turf_decal/stripes/line,
/turf/open/floor/plasteel,
/area/ruin/powered/ancient_bunker_vault)
"y" = (
/obj/structure/table,
/obj/item/flashlight/seclite,
/obj/effect/turf_decal/stripes/line,
/turf/open/floor/plasteel,
/area/ruin/powered/ancient_bunker_vault)
"z" = (
/obj/effect/turf_decal/stripes/line{
	dir = 6
	},
/turf/open/floor/plasteel,
/area/ruin/powered/ancient_bunker_vault)
"A" = (
/obj/structure/fans/tiny,
/obj/machinery/door/airlock/hatch,
/turf/open/floor/plating,
/area/ruin/powered/ancient_bunker_vault)
"B" = (
/obj/structure/table,
/obj/effect/turf_decal/stripes/line{
	dir = 4
	},
/obj/item/storage/toolbox/emergency,
/turf/open/floor/plating,
/area/ruin/powered/ancient_bunker_vault)
"C" = (
/obj/structure/table,
/obj/effect/turf_decal/stripes/line{
	dir = 8
	},
/obj/item/storage/firstaid/o2,
/turf/open/floor/plating,
/area/ruin/powered/ancient_bunker_vault)
"D" = (
/obj/machinery/suit_storage_unit/standard_unit,
/obj/effect/turf_decal/stripes/line{
	dir = 4
	},
/turf/open/floor/plating,
/area/ruin/powered/ancient_bunker_vault)
"E" = (
/obj/machinery/suit_storage_unit/open,
/obj/effect/turf_decal/stripes/line{
	dir = 8
	},
/turf/open/floor/plating,
/area/ruin/powered/ancient_bunker_vault)

(1,1,1) = {"
a
a
a
b
b
a
b
a
a
a
a
a
a
e
e
e
e
e
e
e
e
a
a
a
a
"}
(2,1,1) = {"
a
a
b
b
b
b
b
e
e
e
e
e
e
e
g
g
g
g
s
v
e
a
a
a
a
"}
(3,1,1) = {"
a
b
b
c
c
c
c
c
f
d
d
d
d
e
g
g
g
g
s
v
e
e
e
e
a
"}
(4,1,1) = {"
b
b
b
c
d
d
d
c
d
d
d
d
d
e
g
g
g
e
e
e
e
B
D
e
a
"}
(5,1,1) = {"
a
b
b
c
d
d
d
d
d
d
d
d
d
e
g
g
g
e
i
w
A
g
g
A
a
"}
(6,1,1) = {"
a
b
b
c
d
d
d
d
d
d
d
d
d
e
h
e
e
e
j
x
A
g
g
A
a
"}
(7,1,1) = {"
a
b
b
c
d
d
d
c
d
d
d
d
d
d
i
l
o
o
t
x
e
C
E
e
a
"}
(8,1,1) = {"
a
b
b
c
c
c
c
c
d
d
d
d
d
e
j
m
d
q
q
y
e
e
e
e
a
"}
(9,1,1) = {"
a
a
b
b
b
b
b
e
e
e
e
e
e
e
k
n
p
r
u
z
e
a
a
a
a
"}
(10,1,1) = {"
a
a
a
a
a
b
b
b
a
a
a
a
a
e
e
e
e
e
e
e
e
a
a
a
a
"}
