//MAP CONVERTED BY dmm2tgm.py THIS HEADER COMMENT PREVENTS RECONVERSION, DO NOT REMOVE
"a" = (
/turf/open/floor/plating/asteroid/terraformable,
/area/ruin/powered/escape_pod)
"b" = (
/obj/effect/spawner/structure/window/shuttle,
/turf/open/floor/plating,
/area/ruin/powered/escape_pod)
"c" = (
/obj/item/chair,
/obj/effect/decal/cleanable/blood/drip{
	icon_state = "xsplatter3"
	},
/turf/open/floor/plating,
/area/ruin/powered/escape_pod)
"d" = (
/obj/structure/bed,
/obj/machinery/light/small/broken{
	icon_state = "bulb-broken";
	dir = 8
	},
/turf/open/floor/plating,
/area/ruin/powered/escape_pod)
"e" = (
/obj/effect/turf_decal/stripes/line{
	dir = 5
	},
/obj/machinery/power/rtg,
/obj/structure/cable{
	icon_state = "0-4"
	},
/obj/machinery/light/small/broken,
/turf/open/floor/plating,
/area/ruin/powered/escape_pod)
"f" = (
/obj/effect/decal/cleanable/blood/tracks{
	icon_state = "tracks";
	dir = 1
	},
/turf/open/floor/plating,
/area/ruin/powered/escape_pod)
"g" = (
/obj/structure/cable{
	icon_state = "0-8"
	},
/obj/machinery/power/smes,
/obj/effect/turf_decal/stripes/line{
	dir = 9
	},
/obj/machinery/light/small/broken,
/turf/open/floor/plating,
/area/ruin/powered/escape_pod)
"h" = (
/obj/machinery/door/airlock/shuttle{
	name = "escape pod"
	},
/turf/open/floor/plating,
/area/ruin/powered/escape_pod)
"i" = (
/obj/structure/door_assembly/door_assembly_shuttle{
	anchored = 1
	},
/obj/effect/decal/cleanable/blood/tracks{
	icon_state = "tracks";
	dir = 8
	},
/turf/open/floor/plating,
/area/ruin/powered/escape_pod)
"j" = (
/obj/item/twohanded/spear{
	pixel_x = -2;
	pixel_y = -2
	},
/turf/open/floor/plating,
/area/ruin/powered/escape_pod)
"k" = (
/obj/effect/decal/cleanable/blood/tracks{
	icon_state = "tracks";
	dir = 8
	},
/turf/open/floor/plating,
/area/ruin/powered/escape_pod)
"l" = (
/obj/effect/decal/cleanable/blood/tracks{
	icon_state = "tracks";
	dir = 10
	},
/turf/open/floor/plating,
/area/ruin/powered/escape_pod)
"m" = (
/obj/machinery/light/small/broken{
	icon_state = "bulb-broken";
	dir = 4
	},
/obj/structure/closet/emcloset/anchored,
/turf/open/floor/plating,
/area/ruin/powered/escape_pod)
"n" = (
/obj/structure/table,
/obj/item/paper/crumpled/bloody/ruins/planet/escape_pod{
	pixel_x = -8;
	pixel_y = 5
	},
/obj/item/artifact/easy{
	pixel_x = 6;
	pixel_y = 1
	},
/turf/open/floor/plating,
/area/ruin/powered/escape_pod)
"o" = (
/obj/structure/table_frame,
/turf/open/floor/plating,
/area/ruin/powered/escape_pod)
"p" = (
/obj/item/bedsheet,
/turf/open/floor/plating,
/area/ruin/powered/escape_pod)
"q" = (
/obj/structure/table,
/obj/item/storage/toolbox/mechanical{
	pixel_x = 1;
	pixel_y = 5
	},
/turf/open/floor/plating,
/area/ruin/powered/escape_pod)
"r" = (
/obj/effect/decal/cleanable/blood/tracks{
	icon_state = "tracks";
	dir = 10
	},
/obj/item/reagent_containers/food/snacks/candy{
	pixel_x = 5;
	pixel_y = 9
	},
/turf/open/floor/plating,
/area/ruin/powered/escape_pod)
"s" = (
/turf/closed/wall/mineral/titanium,
/area/ruin/powered/escape_pod)
"t" = (
/obj/item/flashlight/lantern{
	on = 1;
	pixel_x = -3;
	pixel_y = -3
	},
/turf/open/floor/plating/asteroid/terraformable,
/area/ruin/powered/escape_pod)
"u" = (
/obj/structure/shuttle/engine/propulsion,
/turf/open/floor/plating/asteroid/terraformable,
/area/ruin/powered/escape_pod)
"v" = (
/obj/effect/decal/cleanable/blood/tracks{
	icon_state = "tracks";
	dir = 5
	},
/turf/open/floor/plating,
/area/ruin/powered/escape_pod)
"w" = (
/obj/machinery/door/airlock/shuttle{
	name = "escape pod"
	},
/obj/effect/decal/cleanable/blood/tracks{
	icon_state = "tracks";
	dir = 1
	},
/turf/open/floor/plating,
/area/ruin/powered/escape_pod)
"x" = (
/obj/structure/shuttle/engine/heater,
/obj/structure/window/reinforced,
/obj/structure/window/reinforced{
	dir = 1
	},
/turf/open/floor/plating,
/area/ruin/powered/escape_pod)
"y" = (
/obj/effect/decal/cleanable/blood/tracks{
	icon_state = "tracks";
	dir = 8
	},
/turf/open/floor/plating/asteroid/terraformable,
/area/ruin/powered/escape_pod)
"z" = (
/obj/effect/decal/cleanable/blood/old,
/turf/open/floor/plating/asteroid/terraformable,
/area/ruin/powered/escape_pod)
"A" = (
/obj/effect/decal/cleanable/blood/drip,
/turf/open/floor/plating/asteroid/terraformable,
/area/ruin/powered/escape_pod)
"B" = (
/turf/template_noop,
/area/template_noop)
"W" = (
/turf/open/floor/plating,
/area/ruin/powered/escape_pod)

(1,1,1) = {"
B
B
B
B
B
B
B
B
B
B
"}
(2,1,1) = {"
B
B
B
B
t
B
B
B
B
B
"}
(3,1,1) = {"
B
s
s
s
s
B
B
B
B
B
"}
(4,1,1) = {"
s
s
d
r
s
s
h
s
s
a
"}
(5,1,1) = {"
b
o
p
k
s
q
W
e
x
u
"}
(6,1,1) = {"
b
n
c
v
w
f
l
g
x
u
"}
(7,1,1) = {"
s
s
m
j
s
s
i
s
s
a
"}
(8,1,1) = {"
B
s
s
s
s
B
y
B
B
B
"}
(9,1,1) = {"
B
B
B
B
B
B
y
B
B
B
"}
(10,1,1) = {"
B
B
B
B
B
A
B
z
B
B
"}
