"a" = (/turf/open/floor/plating/asteroid/terraformable,/area/ruin/unpowered)
"b" = (/turf/closed/wall/mineral/sandstone,/area/ruin/unpowered)
"c" = (/obj/structure/fluff/divine/conduit/shrine_ruin,/turf/open/floor/plating/planet_atmos,/area/ruin/unpowered)
"d" = (/turf/open/floor/plating/planet_atmos,/area/ruin/unpowered)
"e" = (/obj/structure/fluff/divine/shrine/shrine_ruin,/turf/open/floor/plating/planet_atmos,/area/ruin/unpowered)
"f" = (/obj/structure/table/wood/fancy/black,/obj/effect/spawner/lootdrop/maintenance,/turf/open/floor/plating/planet_atmos,/area/ruin/unpowered)
"g" = (/obj/structure/table/wood/fancy/cyan,/obj/item/shard{pixel_x = 2; pixel_y = 4},/turf/open/floor/plating/planet_atmos,/area/ruin/unpowered)
"h" = (/obj/structure/table/wood/fancy/exoticblue,/obj/item/storage/firstaid/ancient,/turf/open/floor/plating/planet_atmos,/area/ruin/unpowered)
"i" = (/obj/structure/table/wood/fancy/red,/obj/item/melee/chainofcommand/tailwhip,/turf/open/floor/plating/planet_atmos,/area/ruin/unpowered)
"j" = (/obj/effect/decal/remains/human,/turf/open/floor/plating/planet_atmos,/area/ruin/unpowered)
"k" = (/obj/effect/decal/remains/human,/turf/open/floor/plating/asteroid/terraformable,/area/ruin/unpowered)

(1,1,1) = {"
abbaaabba
bcfbabdcb
bdaaaaagb
abajddaba
aaadedaaa
abadddkba
bhaaaaadb
bcdbabicb
abbaaabba
"}
